0 0 2 2 2 2 2 2.
0 0 2 5 5 5 5 2.
2 2 2 3 3 3 5 2.
2 1 5 3 4 4 5 2.
2 5 3 4 4 4 2 2.
2 2 2 2 5 5 2 0.
0 0 0 2 2 2 2 0.